[ 4 décembre 2021 ] Grande muraille verte : 4e rencontre au sommet sur le financement du programme	Environnement	
[ 1 décembre 2021 ] Réseau des organismes de gestion des financements aux médias de la CEDEAO : Ag Ibrahim Mohamed prend les rênes !	SOCIETE	
[ 30 novembre 2021 ] Burkina: Les boulangers annoncent une augmentation du prix du pain	SOCIETE	
[ 28 novembre 2021 ] Message du président du Faso a la nation : Les Burkinabè veulent désormais plus de pragmatisme !	DEFENSE-SECURITE	
[ 28 novembre 2021 ] Accusation contre le Maroc : L’incroyable CSC de Abdelmadjid Tebboune !	SPORT	
[ 26 novembre 2021 ] Présence chefs militaires au front, opération mains propres, gouvernement resserré : Les grandes décision de Roch Kaboré	POLITIQUE	
[ 25 novembre 2021 ] COMPTE RENDU DU CONSEIL DES MINISTRES DU JEUDI 25 NOVEMBRE 2021	Communiqués	
[ 25 novembre 2021 ] Marche du 27 novembre : « Nous refusons d’être utilisés comme des cow-boys », coalition des délégués des élèves du Kadiogo	POLITIQUE	
[ 25 novembre 2021 ] Marche du 27 novembre : La jeunesse du CFOP donne son quitus !	POLITIQUE	
[ 25 novembre 2021 ] Situation nationale : « Demander la démission du chef de l’Etat est légitime pour tout Burkinabè », Action concorde	POLITIQUE	
[ 23 novembre 2021 ] Sanaba/Province des Banwa: Des hommes armés endommagent le commissariat de police	DEFENSE-SECURITE	
[ 23 novembre 2021 ] Suspension internet mobile : Le gouvernement s’explique !	SOCIETE	
[ 23 novembre 2021 ] Suspension d’internet mobile : Eddie Komboïgo dénonce une « mesure arbitraire, abusive et injuste »	POLITIQUE	
[ 21 novembre 2021 ] Burkina : La connexion mobile perturbée	ECONOMIE-DEVELOPPEMENT	
[ 19 novembre 2021 ] Reconstitution du Fonds mondial VIH/SIDA, tuberculose, paludisme : Le président du Faso échange avec le directeur exécutif	Santé	
[ 19 novembre 2021 ] Conseil supérieur de la magistrature : Prendre des décisions pour accroître la crédibilité de la justice	SOCIETE	
[ 19 novembre 2021 ] Criminalité à Ouaga : Un groupe de présumés délinquants dans les filets de la police nationale	DEFENSE-SECURITE	
[ 18 novembre 2021 ] Financement du PNDES II : La BOAD exprime son intérêt	ECONOMIE-DEVELOPPEMENT	
[ 18 novembre 2021 ] Burkina : Des manifestants bloquent un convoi de l’armée française dans plusieurs villes	DEFENSE-SECURITE	
[ 17 novembre 2021 ] Drame d’Inata : « L’ensemble des personnes concernées feront l’objet de sanctions disciplinaires sans exception », Roch Kaboré	DEFENSE-SECURITE	
[ 17 novembre 2021 ] COMPTE-RENDU DU CONSEIL DES MINISTRES DU 17 NOVEMBRE 2021	Communiqués	
[ 17 novembre 2021 ] Drame d’Inata : le commandant du Groupement des forces du secteur Nord et celui de la 1re Région de gendarmerie relevés de leurs fonctions !	DEFENSE-SECURITE	
[ 17 novembre 2021 ] Burkina : Réouverture des frontières le 1er décembre, voici les conditions !	SOCIETE	
[ 15 novembre 2021 ] Attaque détachement gendarmerie Inata : le bilan revu à la hausse !	DEFENSE-SECURITE	
[ 15 novembre 2021 ] Attaque meurtrière à Inata : Un deuil national de 72h décrété !	DEFENSE-SECURITE	
[ 14 novembre 2021 ] Banfora : 4 blessés dans un accident à Nofona	SOCIETE	
[ 14 novembre 2021 ] Détachement de gendarmerie d’Inata (Soum) : une vingtaine de personnes tuées	DEFENSE-SECURITE	
[ 12 novembre 2021 ] Union panafricaine de la jeunesse : Le siège central bientôt transféré au Maroc	SOCIETE	
[ 10 novembre 2021 ] Procès assassinat Sankara : Passe d’armes entre Gilbert Diendéré et Me Farama	DEFENSE-SECURITE	
[ 9 novembre 2021 ] Lutte contre le terrorisme : Des acteurs économiques sollicitent les détenteurs de pouvoirs mystiques	DEFENSE-SECURITE	
[ 7 novembre 2021 ] Commune de Pensa : Des femmes battues par des HANI	SOCIETE	
[ 21 octobre 2021 ] « Truth Social » : Le réseau social de Donald Trump sera lancé début 2022	INTERNATIONAL	
[ 17 octobre 2021 ] Concurrence déloyale et détournement de fonds à la SITAB : L’ex-DG Omaïs attendu à la barre ce 25 octobre	ECONOMIE-DEVELOPPEMENT	
[ 16 octobre 2021 ] Saga Den, artiste chanteur burkinabè : « Nous n’avons pas d’identité musicale »	CULTURE	
[ 16 octobre 2021 ] 27e FESPACO 20 : Le président du Faso donnera le clap	CULTURE	
[ 16 octobre 2021 ] Région de l’Est : Les agents de santé enlevés libérés	Uncategorized	
[ 15 octobre 2021 ] Coopération sino-burkinabè : La Chine offre plus de 711 000 000 FCFA de matériel aux déplacés internes	Coopération	
[ 15 octobre 2021 ] Assurances au Burkina : AfricInvest s’associe à Raynal Assurances	ECONOMIE-DEVELOPPEMENT	
[ 14 octobre 2021 ] Région de l’Est : Les agents de santé enlevés libérés	DEFENSE-SECURITE	
[ 13 octobre 2021 ] Ouaga : Plusieurs foyers de présumés délinquants démantelés	DEFENSE-SECURITE	
[ 13 octobre 2021 ] FESPACO : L’Ambassade de Chine offre du matériel cinématographique	CULTURE	
[ 7 octobre 2021 ] Procès Thomas Sankara : « L’absence de Blaise Compaoré n’est pas un problème », Balai citoyen	POLITIQUE	
[ 7 octobre 2021 ] Tour du Faso 2021 : La LONAB offre 150 millions FCFA	SPORT	
[ 7 octobre 2021 ] Partis sankaristes : Le parti de la justice et du développement rejoint le navire	POLITIQUE	
[ 7 octobre 2021 ] Assassinat Thomas Sankara : Blaise Compaoré ne viendra pas au procès	SOCIETE	
[ 7 octobre 2021 ] Afrique : L’OMS approuve l’utilisation du Mosquirix, le tout premier vaccin antipaludique	Santé	
[ 6 octobre 2021 ] Burkina : Le général Gilbert Ouédraogo nouveau chef d’état-major général des armées	DEFENSE-SECURITE	
[ 6 octobre 2021 ] Burkina : Et si on célébrait nos héros tombés autrement que par un deuil national?	DEFENSE-SECURITE	
[ 5 octobre 2021 ] Insécurité : Un braquage fait un mort et des blessés	SOCIETE	
[ 4 octobre 2021 ] MPP : Les mots forts du nouveau président Sakandé	POLITIQUE	
[ 1 octobre 2021 ] Insécurité routière : Sept véhicules en fourrière	SOCIETE	
[ 1 octobre 2021 ] Environnement : des journalistes se familiarisent avec l’écofiscalité	Environnement	
[ 29 septembre 2021 ] Education : le SYNAFEB dénonce un crime économique contre les carrières des enseignants	Education	
[ 29 septembre 2021 ] Conseil régional du Centre : Le président Éric Tiemtoré appelle les conseillers à se faire vacciner	Santé	
[ 29 septembre 2021 ] Incidents à Titao : le CISC demande la dissolution « de toutes milices armées »	DEFENSE-SECURITE	
[ 28 septembre 2021 ] Accident à Dapélogo/Plateau central : Un mort et douze blessés	SOCIETE	
[ 27 septembre 2021 ] Dialogue politique : Les travaux ont repris ce lundi 27 septembre	POLITIQUE	
[ 26 septembre 2021 ] Mouvement du peuple pour le progrès : Voici la composition du bureau exécutif national	POLITIQUE	
[ 26 septembre 2021 ] Présidence du MPP : Simon Compaoré passe le témoin à Alassane Bala Sakandé	POLITIQUE	
[ 24 septembre 2021 ] Province du Soum : Le ministre Ousseni Tamboura fait don d’ordinateurs au CILDES	ECONOMIE-DEVELOPPEMENT	
[ 24 septembre 2021 ] PMUB : André Tassembédo reçoit son chèque de plus de 91 millions FCFA.	ECONOMIE-DEVELOPPEMENT	
[ 24 septembre 2021 ] 2e congrès extraordinaire MPP : le renouvellement de la direction politique nationale comme plat de résistance	POLITIQUE	
[ 23 septembre 2021 ] Le philosophe Bilal Ramadan : « Refuser de négocier avec les terroristes, c’est refuser la paix »	POLITIQUE	
[ 23 septembre 2021 ] Brésil : Un fût de bière tue un homme le jour de son anniversaire	INTERNATIONAL	
[ 23 septembre 2021 ] Trafic ce carburant dans la région de l’Est : 72 personnes en garde à vue	DEFENSE-SECURITE	
[ 23 septembre 2021 ] Energies renouvelables : Les acteurs sensibilisés sur les énergies africaines	Environnement	
[ 23 septembre 2021 ] Brad Pit et Angelina Jolie : Cinq ans après la séparation, le couple se déchire pour un château	INTERNATIONAL	
[ 22 septembre 2021 ] COMPTE RENDU DU CONSEIL DES MINISTRES DU 22 SEPTEMBRE 2021	Conseil des ministres	
[ 22 septembre 2021 ] Ambassadeurs de paix awards : Bilan satisfaisant pour une première édition	SOCIETE	
[ 22 septembre 2021 ] Secteur minier : Enfin un décret favorisant le Burkina Faso	ECONOMIE-DEVELOPPEMENT	
[ 22 septembre 2021 ] FAIB : Le président de la CENI recueille les attentes	POLITIQUE	
[ 21 septembre 2021 ] Ouaga : Il simule son propre enlèvement pour soutirer 5 000 000 FCFA à ses parents	DEFENSE-SECURITE	
[ 21 septembre 2021 ] Assemblée nationale : 100 étudiants en stage	SOCIETE	
[ 20 septembre 2021 ] Simon Compaoré, président du MPP : « Roch ne peut jamais tenter un troisième mandat »	POLITIQUE	
[ 20 septembre 2021 ] Assemblée générale de l’AJSB : Les journalistes sportifs font le bilan de leurs activités	SPORT	
[ 19 septembre 2021 ] Pr Stanislas Ouaro : « On m’a instruit de rouvrir le lycée Zinda pour la rentrée scolaire 2022-2023 »	Education	
[ 19 septembre 2021 ] Présidentielle 2022 aux Philippines : Le boxeur Manny Pacquiao se déclare candidat	INTERNATIONAL	
[ 19 septembre 2021 ] Covid-19 : Le Burkina reçoit 400 mille doses du vaccin Sinopharm	Coopération	
[ 18 septembre 2021 ] Journées de concertation Etat-ONG: Le chômage des jeunes au cœur des échanges	SOCIETE	
[ 18 septembre 2021 ] Communes de Ouaga et de Bobo : Les conseillers plaident pour des arrondissements autonomes	SOCIETE	
[ 17 septembre 2021 ] Sécurité des patients : Des réflexions pour favoriser des soins maternels et néonatals sans risque	Santé	
[ 17 septembre 2021 ] Décès d’une vieille à Kaya : Les responsables au CHR ont présenté leurs condoléances	Santé	
[ 17 septembre 2021 ] Pollution de l’environnement : Un cross populaire pour sensibiliser et interpeller les populations	Environnement	
[ 17 septembre 2021 ] Assises nationales de l’éducation : Voici les 12 thématiques retenues	Education	
[ 16 septembre 2021 ] Lutte contre la COVID 19 : Bientôt des centres de vaccination au sein des entreprises privées	Santé	
[ 16 septembre 2021 ] Protection de la couche d’ozone : Un projet pour refroidir la planète	Environnement	
[ 16 septembre 2021 ] Incident à la gare de l’Est : « En aucun cas, il y a eu usage d’arme à feu », la Police municipale	DEFENSE-SECURITE	
[ 16 septembre 2021 ] Approvisionnement en eau : La CEDEAO outille les pays membres sur la collecte des données	SOCIETE	
[ 16 septembre 2021 ] Sécurité : Les 21 policiers licenciés vont reprendre service	DEFENSE-SECURITE	
[ 16 septembre 2021 ] Musique : Amity Meria revient avec Yankaw	CULTURE	
[ 15 septembre 2021 ] Lutte contre la vie chère : Plus d’une tonne de produits alimentaires saisie	ECONOMIE-DEVELOPPEMENT	
[ 15 septembre 2021 ] Filière anacarde : Les acteurs reçoivent des équipements d’une valeur de 270 millions F CFA	ECONOMIE-DEVELOPPEMENT	
[ 14 septembre 2021 ] Abdoulaye Diop, président commission UEMOA : « Les gens doivent pouvoir circuler librement dans l’union »	SOCIETE	
[ 14 septembre 2021 ] Economie, sécurité, agriculture : Bientôt des projets entre l’Arabie Saoudite et le Burkina	Coopération	
[ 14 septembre 2021 ] 3e dialogue national sur le fonds vert : La mobilisation des ressources au cœur des échanges	Environnement	
[ 14 septembre 2021 ] Hygiène et assainissement : Des hommes de média outillés	FASO INSIDE	
[ 14 septembre 2021 ] Eddie Komboïgo : « Alpha Condé est la honte de l’opposition dans le monde »	POLITIQUE	
[ 13 septembre 2021 ] Journées à faibles émissions de carbone : La 9e édition officiellement lancée	Environnement	
[ 13 septembre 2021 ] MPP : Les grandes décisions de la 4e session ordinaire du bureau politique national	POLITIQUE	
[ 12 septembre 2021 ] Foubé ou la croisade des femmes : Un ouvrage sur la vie des personnes déplacées internes	CULTURE	
[ 11 septembre 2021 ] Vaccin contre la COVID-19 : Un site internet pour alléger le processus	Santé	
[ 10 septembre 2021 ] Région des Cascades : Ousseni Tamboura échange avec les hommes de média	Medias	
[ 10 septembre 2021 ] Bureau burkinabè du droit d’auteur : Plus d’un milliard FCFA à distribuer en 2021	CULTURE	
[ 10 septembre 2021 ] Formation professionnelle des artisans : Un accord de partenariat entre la Chambre des métiers et le ministère de l’Emploi	SOCIETE	
[ 9 septembre 2021 ] FESPACO 2021: 239 films sélectionnés	CULTURE	
[ 9 septembre 2021 ] Issaka Ouédraogo, président du CISAG: « Le président du Faso doit se débarrasser de certains ministres»	POLITIQUE	
[ 9 septembre 2021 ] Coup d’Etat en Guinée Conakry : Le président bissau-guinéen s’insurge contre les sanctions de la CEDEAO	INTERNATIONAL	
[ 8 septembre 2021 ] France 24 : Amobé Mévégué est mort	INTERNATIONAL	
[ 7 septembre 2021 ] Monnaie électronique : Faso money entre en scène !	ECONOMIE-DEVELOPPEMENT	
[ 7 septembre 2021 ] Recherche et innovation : Le FONRID commémore ses noces d’étain	Education	
[ 6 septembre 2021 ] Dr Alain Zoubga : « Rien ne permet d’espérer une amélioration réelle de la situation sécuritaire dans les semaines voire les mois à venir »	DEFENSE-SECURITE	
[ 6 septembre 2021 ] CENI : Les recommandations de la communauté catholique au nouveau président	POLITIQUE	
[ 5 septembre 2021 ] Politique : Le PS-Burkina officiellement dissout	POLITIQUE	
[ 5 septembre 2021 ] Guinée : Des tirs nourris aux alentours de la présidence	INTERNATIONAL	
[ 5 septembre 2021 ] Boinga/Centre-nord : Des présumés terroristes incendies une centaine de boutiques	DEFENSE-SECURITE	
[ 4 septembre 2021 ] Burkina : Nana Thibault appelle à une réconciliation nationale juste et rapide pour le développement du pays	POLITIQUE	
[ 3 septembre 2021 ] Congrès extraordinaire du Parti socialiste du Burkina : une nouvelle vision pour le développement du Burkina	POLITIQUE	
[ 2 septembre 2021 ] Côte d’Ivoire : L’animateur Yves de Mbella condamné à 12 mois de prison avec sursis et 2 millions d’amende	INTERNATIONAL	
[ 1 septembre 2021 ] CHR de Kaya : Une vieille dame meurt pour non assistance	SOCIETE	
[ 31 août 2021 ] Crise sécuritaire dans l’Est : Les graves révélations d’Adolphe Lankoandé, maire de Bogandé DEFENSE-SECURITE	
[ 31 août 2021 ] Processus électoral : Le président de la CENI demande le soutien du Premier ministre	POLITIQUE	
[ 31 août 2021 ] Protocole de fusion UNIR/PS-MPS : Trois nouveaux partis rejoignent le navire	POLITIQUE	
[ 31 août 2021 ] Université de Koudougou : 4 morts suite à l’effondrement d’un bâtiment en construction	Education	
[ 31 août 2021 ] Subvention à la presse privée : Des responsables de médias à l’école de la bonne conduite	Medias	
[ 31 août 2021 ] Assises nationales de l’éducation : Le ministre Ouaro reçoit le document de base	Education	
[ 30 août 2021 ] Menaces terroristes et liberté de presse : Les problèmes des journalistes passés en revue	DEFENSE-SECURITE	
[ 30 août 2021 ] SOS : Appel à la solidarité pour la petite Léo Kadi	Santé	
[ 29 août 2021 ] Lynchage des trois agents du CCVA : Les corps retrouvés dans un champ de maïs, deux interpellations	SOCIETE	
[ 29 août 2021 ] Lynchage de trois agents du CCVA : Deux personnes interpellées	DEFENSE-SECURITE	
[ 28 août 2021 ] Banlo /Sud-Ouest : 3 personnes lynchées après avoir percuté à mort un enfant	SOCIETE	
[ 28 août 2021 ] Lutte contre le terrorisme : 151 GARSI prêts à servir	DEFENSE-SECURITE	
[ 28 août 2021 ] Ministère de l’Environnement : Le budget du programme BKF/023 en adoption	Environnement	
[ 27 août 2021 ] ADCT : Les administrateurs prennent fonction	Uncategorized	
[ 27 août 2021 ] Prévention des crises électorales : Elysé Ouédraogo et son équipe en quête de conseils chez le Mogho	POLITIQUE	
[ 26 août 2021 ] Sécurité routière : Les conducteurs de tricycles se familiarisent avec le code de la route	SOCIETE	
[ 26 août 2021 ] Armée burkinabè en 2031 : Le rêve de Jérémie Yisso Bationo	DEFENSE-SECURITE	
[ 26 août 2021 ] Vols d’engins à deux roues à Bobo : Quatre présumés voleurs aux arrêts	DEFENSE-SECURITE	
[ 25 août 2021 ] Lutte contre le terrorisme : l’Arabie Saoudite veut aider le Burkina Faso	DEFENSE-SECURITE	
[ 25 août 2021 ] Divertissement et gastronomie : La 8e édition des MADIGO prévue le 17 décembre	SOCIETE	
[ 25 août 2021 ] Retrait des militaires tchadiens : « Nous devrons apprendre à compter sur nos propres forces », Abraham Badolo de l’ADP	DEFENSE-SECURITE	
[ 24 août 2021 ] Coopération Burkina-Tunisie : Le diplomate Mohamed Kahloum fait ses adieux au président du Faso	Coopération	
[ 24 août 2021 ] MENAPLN : Les affectations pour nécessité de service suspendues	Education	
[ 23 août 2021 ] Procès de l’insurrection populaire : « Le dossier est en état d’être jugé, il reste à fixer la date», procureur général près la cour de cassation, Dama Ouali	POLITIQUE	
[ 23 août 2021 ] Sécurité intérieure : Dotation en équipements de la police et la gendarmerie	DEFENSE-SECURITE	
[ 23 août 2021 ] Municipales de 2022 : « Il revient au gouvernement et aux acteurs politiques de s’accorder sur le contenu du processus», Elysé Ouédraogo, président de la CENI	POLITIQUE	
[ 20 août 2021 ] CENI : Elisée Ouédraogo sollicite l’accompagnement de Roch Marc Kaboré	POLITIQUE	
[ 20 août 2021 ] Insertion socioprofessionnelle : La Chine offre des kits d’installation à une cinquantaine de jeunes diplômés	SOCIETE	
[ 19 août 2021 ] Prise de décisions au Burkina: L’Association monde rural milite pour l’inclusion des femmes	Environnement	
[ 19 août 2021 ] Développement industriel : Des entrepreneurs burkinabè et tunisiens partagent leurs expériences ECONOMIE-DEVELOPPEMENT	
[ 17 août 2021 ] Ministère du commerce : L’ONACOM-B dénonce une gestion chaotique et catastrophique	ECONOMIE-DEVELOPPEMENT	
[ 17 août 2021 ] Élie Tarpaga président de la CDAIP : « C’est la présence de l’armée française et de ses alliés américains qui est la source principale du terrorisme »	DEFENSE-SECURITE	
[ 16 août 2021 ] Election en Zambie : L’opposant Hakainde Hichilema élu président	INTERNATIONAL	
[ 16 août 2021 ] Province du Soum : Une dizaine de terroristes mis hors d’état de nuire	DEFENSE-SECURITE	
[ 13 août 2021 ] Flambée des produits de grande consommation : le CFOP met en garde le gouvernement	ECONOMIE-DEVELOPPEMENT	
[ 13 août 2021 ] Arrestation de Pascal Zaïda : « Ce qu’on leur demande, c’est d’aller faire reculer les bandits au niveau des frontières », Eddie Komboïgo	POLITIQUE	
[ 12 août 2021 ] Province du Kadiogo : Bala Sakandé au chevet des personnes vulnérables	FASO INSIDE	
[ 11 août 2021 ] Litige foncier à Komsilga : Le maire s’explique !	FASO INSIDE	
[ 10 août 2021 ] Résilience sanitaire au Burkina : Des régions dotées de matériels médico-techniques et roulants	Santé	
[ 10 août 2021 ] Non application convention collective dans les médias privés : Des journalistes demandent l’aide de l’Etat	FASO INSIDE	
[ 10 août 2021 ] Secteur des BTP : Bientôt une convention collective pour garantir un emploi décent	ECONOMIE-DEVELOPPEMENT	
[ 9 août 2021 ] Elections consulaires 2021 : la CASCA-BF sensibilise des commerçants	ECONOMIE-DEVELOPPEMENT	
[ 9 août 2021 ] Litige foncier à Komsilga : En colère, des riverains barricadent la RN6	FASO INSIDE	
[ 9 août 2021 ] Gestion aéroport de Donsin : Grève des syndicats de l’aéronautique à partir du 26 août ECONOMIE-DEVELOPPEMENT	
[ 9 août 2021 ] Campagne de reboisement : Eddie Komboïgo remonté contre la mise à l’écart du CFOP	Uncategorized	
[ 8 août 2021 ] Journée nationale de l’arbre : 11 personnes décorées	Environnement	
[ 7 août 2021 ] Journée nationale de l’arbre 2021: Le président Kaboré donne le top de départ, 10 millions de plants attendus	Environnement	
[ 4 août 2021 ] CNSS : La CGTB réclame le départ du directeur général	FASO INSIDE	
[ 3 août 2021 ] Journée de l’excellence scolaire : 99 lauréats récompensés par le président du Faso	Education	
[ 3 août 2021 ] 3e édition Journée nationale de l’arbre : 300 000 plants attendus	Environnement	
[ 2 août 2021 ] Assemblée nationale : Les membres du comité d’élaboration du plan stratégique installés	Coopération	
[ 2 août 2021 ] L’ambassadeur de France chez Christophe Dabiré : Sécurité et infrastructures aéroportuaires au menu des échanges	DEFENSE-SECURITE	
[ 31 juillet 2021 ] 6es journées vétérinaires : Développement de l’élevage et promotion de la santé publique au cœur des débats	FASO INSIDE	
[ 30 juillet 2021 ] Extradition François Compaoré : Le Conseil d’état français valide	Coopération	
[ 30 juillet 2021 ] Délinquance urbaine : Deux frères épinglés	DEFENSE-SECURITE	
[ 29 juillet 2021 ] Récurrence des cas d’arrêt cardiaques : La Croix-rouge burkinabè sensibilise les populations	Santé	
[ 29 juillet 2021 ] 27e édition du FESPACO : Tout est prêt à 70%	CULTURE	
[ 29 juillet 2021 ] CENI : les nouveaux commissaires prêtent enfin serment !	POLITIQUE	
[ 29 juillet 2021 ] Lutte contre la contrefaçon : Des produits d’une valeur d’environ 10 millions F CFA saisis	DEFENSE-SECURITE	
[ 29 juillet 2021 ] Hépatite : Environ 3 millions de porteurs chroniques dans la nature	Santé	
[ 28 juillet 2021 ] Récusation représentant chefferie à la CENI : Le MPC fustige l’attitude du CFOP	POLITIQUE	
[ 27 juillet 2021 ] Lutte contre la Covid-19 : Des volontaires licenciés réclament plus de 900 millions FCFA	Santé	
[ 27 juillet 2021 ] Grogne au ministère de l’Environnement : Le SYNAE suspend ses mouvements de protestations	Environnement	
[ 27 juillet 2021 ] Situation de la mine d’Inata : Abraham Badolo exige la rupture du contrat de la société Belahourou	ECONOMIE-DEVELOPPEMENT	
[ 26 juillet 2021 ] CASEM ministère de la santé : deux défis majeurs à relever en 2021	Santé	
[ 26 juillet 2021 ] 9e Traité d’amitié et de coopération : Le PM et son gouvernement sont à Abidjan	Coopération	
[ 26 juillet 2021 ] 2e mandature du Haut conseil du dialogue social : 30 faiseurs de paix installés	SOCIETE	
[ 26 juillet 2021 ] Remise de rapport au président du Faso : « Nous sommes parmi les pays qui organisent les élections moins chères en Afrique », Newton Ahmed Barry	POLITIQUE	
[ 26 juillet 2021 ] Affaire SITAB contre Youssef Omaïs : Le procès renvoyé au 25 octobre	SOCIETE	
[ 25 juillet 2021 ] Réseau des femmes entrepreneures : La section Burkina lance ses activités	SOCIETE	
[ 25 juillet 2021 ] Affaire SITAB-ex-DG Youssef Omaïs : La Justice burkinabè à la croisée des chemins	ECONOMIE-DEVELOPPEMENT	
[ 24 juillet 2021 ] Prévention des changements climatiques : la première pierre du centre de compétence WASCAL posée	Environnement	
[ 24 juillet 2021 ] Ouaga : Un enfant se noie dans le barrage de Tanghin	SOCIETE	
[ 23 juillet 2021 ] 3es concertations nationales sur les systèmes alimentaires : Le Burkina identifie ses axes prioritaires	FASO INSIDE	
[ 23 juillet 2021 ] Lutte contre la flambée des prix et la contrefaçon : 2 964 commerçants sanctionnés	ECONOMIE-DEVELOPPEMENT	
[ 22 juillet 2021 ] Compte-rendu du conseil des ministres du jeudi 22 juillet 2021	Communiqués	
[ 20 juillet 2021 ] Les nouveaux riches : La révolution du cinéma burkinabè	CULTURE	
[ 20 juillet 2021 ] Tabaski 2021 : Prière pour la cohésion sociale et la paix au Burkina	SOCIETE	
[ 20 juillet 2021 ] Divertissement et restauration : La Perle s’exporte à Larlé	ECONOMIE-DEVELOPPEMENT	
[ 19 juillet 2021 ] Conseil constitutionnel : La prestation de serment des commissaires de la CENI n’a pas eu lieu	POLITIQUE	
[ 19 juillet 2021 ] Rencontre gouvernement-syndicats : « L’état du dialogue social est déplorable », Abdoulaye Ouédraogo, représentant des syndicats	SOCIETE	
[ 19 juillet 2021 ] Ministère du Commerce : Le Syndicat dénonce le clientélisme et le populisme du ministre Harouna Kaboré	ECONOMIE-DEVELOPPEMENT	
[ 18 juillet 2021 ] Chorale Marie reine immaculée de Dassasgho : Un concert pour célébrer le jubilée d’argent	SOCIETE	
[ 18 juillet 2021 ] CENI : Newton Ahmed Barry n’est plus commissaire	POLITIQUE	
[ 16 juillet 2021 ] 24e nuit des Galian : Pas de super lauréat cette année, le palmarès complet Medias	
[ 15 juillet 2021 ] CENI : L’élection du président reportée (encore) à lundi	POLITIQUE	
[ 15 juillet 2021 ] 22e AG Etablissements publics de l’Etat : 39,985 milliards de FCFA restent impayés	ECONOMIE-DEVELOPPEMENT	
[ 15 juillet 2021 ] Systèmes alimentaires : le Burkina Faso se prépare pour le sommet mondial	FASO INSIDE	
[ 15 juillet 2021 ] Mode de désignation représentants de l’opposition à la CENI : L’ONA désavoue « une CENI irrégulièrement formée »	POLITIQUE	
[ 15 juillet 2021 ] Dialogue politique : L’ONA rejette le format actuel	POLITIQUE	
[ 14 juillet 2021 ] Affaire récusation du Sao Naaba : « Sa présence remet en cause le principe d’indépendance et d’impartialité de la CENI », Alain Zoubga	POLITIQUE	
[ 14 juillet 2021 ] Lutte contre le terrorisme au Burkina : Le Réveil citoyen projette une marche populaire contre la France	DEFENSE-SECURITE	
[ 14 juillet 2021 ] Incarcération de Jacob Zuma : Plus de 70 morts dans des violences et manifestations	INTERNATIONAL	
[ 13 juillet 2021 ] Récusation du Sao Naaba : « Nous n’avons pas les éléments matériels et juridiques pour engager une procédure », Clément Sawadogo	POLITIQUE	
[ 13 juillet 2021 ] Défense nationale : Le secrétaire général par intérim installé dans ses fonctions	DEFENSE-SECURITE	
[ 13 juillet 2021 ] Réformes dans le secteur immobilier : Des promoteurs immobiliers s’insurgent !	SOCIETE	
[ 12 juillet 2021 ] Nahi Mossi/Sanmatenga : 7 morts dans une attaque	DEFENSE-SECURITE	
[ 12 juillet 2021 ] Covid-19 : Charlemagne Ouédraogo rassure le CFOP sur la qualité de l’AstraZeneca	Santé	
[ 12 juillet 2021 ] Diplomatie : Metsi Makhetha fait ses adieux au PM Dabiré	Coopération	
[ 12 juillet 2021 ] Retrait du CFOP du dialogue politique : « C’est aux partis de l’Opposition de réaliser qu’ils ont fait une erreur et de revenir », Simon Compaoré, président du MPP	POLITIQUE	
[ 12 juillet 2021 ] Marches des 3 et 4 juillet : « L’action de l’opposition encourage les terroristes », Lassané Sawadogo, SEN du MPP	POLITIQUE	
[ 10 juillet 2021 ] Tasbaki 2021 : La FAIB officialise la date	SOCIETE	
[ 10 juillet 2021 ] Burkina : Roch rencontre la hiérarchie, les officiers, sous-officiers et les hommes de rang	DEFENSE-SECURITE	
[ 9 juillet 2021 ] Trafic de drogue à Bobo : 20 kg de cannabis saisis par la Police nationale	DEFENSE-SECURITE	
[ 9 juillet 2021 ] Nouveau système de facturation de l’ONEA : Des parlementaires outillés	SOCIETE	
[ 9 juillet 2021 ] Situation nationale : Le Mouvement populaire du 3 juillet se fait entendre	POLITIQUE	
[ 8 juillet 2021 ] 72h cité universitaire Thomas Sankara : Bruno Dipama, maillot jaune de la journée de salubrité	Environnement	
[ 8 juillet 2021 ] Assises nationales sur l’éducation : Les anciens SG de l’Education marquent leur accord	Education	
[ 8 juillet 2021 ] Me Sankara à propos de la marche du 3 juillet: « C’est un jeu trouble du CFOP »	POLITIQUE	
[ 8 juillet 2021 ] Utilisation des pesticides dans l’agriculture : L’IRSAT attire l’attention sur les dangers	Environnement	
[ 8 juillet 2021 ] BAC 2021 au Burkina : 154 775 candidats en quête du précieux sésame	Education	
[ 7 juillet 2021 ] CENI : Voici l’identité des 15 commissaires	POLITIQUE	
[ 7 juillet 2021 ] Présidence du Faso : Abdoul Karim Sango et Bissiri Joseph Sirima nommés conseillers spéciaux	POLITIQUE	
[ 7 juillet 2021 ] Lutte contre le terrorisme : Le Burkina renforce sa coopération avec la République tchèque	DEFENSE-SECURITE	
[ 7 juillet 2021 ] Burkina : Compte-rendu du conseil des ministres du 7 juillet 2021	Conseil des ministres	
[ 7 juillet 2021 ] Haïti : Le président Jovenel Moïse assassiné dans sa résidence	INTERNATIONAL	
[ 5 juillet 2021 ] Nassirou Dahani, porte-parole des ressortissants de Madjoari : « Si la base militaire est juste là pour protéger le camp, qu’elle s’en aille»	DEFENSE-SECURITE	
[ 2 juillet 2021 ] Référentiel national de développement 2021-2025 : Le projet de document adopté après examen	ECONOMIE-DEVELOPPEMENT	
[ 1 juillet 2021 ] Marche des 3 et 4 juillet : Les militaires et policiers radiés appellent à la mobilisation	POLITIQUE	
[ 1 juillet 2021 ] Marche-meeting du 3 juillet : « Si on gouverne seul, on doit faire face aux problèmes seul », Pr Abdoulaye Soma	POLITIQUE	
[ 30 juin 2021 ] Réaménagement ministériel : Maxime Koné à la Sécurité, Aimé Barthélémy Simporé à la défense	DEFENSE-SECURITE	
[ 30 juin 2021 ] Nouveau gouvernement : Biographie du colonel-major Aimé Barthélémy Simporé	DEFENSE-SECURITE	
[ 30 juin 2021 ] Commercialisation du riz produit au centre-est : Les acteurs réfléchissent à la meilleure stratégie	FASO INSIDE	
[ 30 juin 2021 ] Rencontre gouvernement-patronat : Les préoccupations des entreprises au menu des échanges	ECONOMIE-DEVELOPPEMENT	
[ 30 juin 2021 ] Commercialisation du riz produit au centre-est : Les acteurs réfléchissent à la meilleure stratégie	FASO INSIDE	
[ 30 juin 2021 ] Brigade des douanes de Koudougou : De l’or et du cyanure d’une valeur de plus de 250 millions FCFA saisis	DEFENSE-SECURITE	
[ 30 juin 2021 ] Marche-meeting du 3 juillet : Des OSC appellent à la mobilisation !	POLITIQUE	
[ 30 juin 2021 ] Demande d’autorisation pour la Marche-meeting CFOP des 3 et 4cjuillet : La réponse du maire Béouindé	SOCIETE	
[ 29 juin 2021 ] Attaque de Solhan : Le Balai citoyen porte plainte contre le gouvernement	DEFENSE-SECURITE	
[ 28 juin 2021 ] Situation nationale : Le MPP met en garde contre les manœuvres politiciennes	POLITIQUE	
[ 28 juin 2021 ] Attaque de Solhan : Deux personnes aux arrêts !	DEFENSE-SECURITE	
[ 28 juin 2021 ] Paroisse Notre Dame de Fatima de Dassasgho : La fanfare cœur immaculé de Marie désormais opérationnelle	SOCIETE	
[ 27 juin 2021 ] Lutte contre le terrorisme : Roch veut adapter la stratégie aux nouvelles réalités du terrain	POLITIQUE	
[ 25 juin 2021 ] Faïçal Nanéma président du MDVE : « L’opposition n’a aucune légitimité à demander la démission de qui que ce soit dans ce pays »	POLITIQUE	
[ 24 juin 2021 ] AG des sociétés d’Etat 2020 : Trois entreprises dans le rouge !	ECONOMIE-DEVELOPPEMENT	
[ 24 juin 2021 ] Régions en proie au terrorisme : L’état d’urgence prorogé pour 18 mois	DEFENSE-SECURITE	
[ 22 juin 2021 ] Lutte antiterroriste : Les VDP de la région du Nord demandent des éclaircissements au gouvernement DEFENSE-SECURITE	
[ 18 juin 2021 ] Annulation hadj 2021 au Burkina : Clément Sawadogo donne les raisons	SOCIETE	
[ 17 juin 2021 ] Après le 17 juin : L’avocat Michel Brizoua-Bi analyse le retour de Gbagbo	INTERNATIONAL	
[ 15 juin 2021 ] Burkina : Le grand prix Manéga de la paix sera décerné au président Kaboré	SOCIETE	
[ 15 juin 2021 ] Amadou Diallo président de l’ARY : « Les assaillants sont revenus et ont incendié le CSPS de Solhan »	DEFENSE-SECURITE	
[ 14 juin 2021 ] DCPM Environnement : Kalfa Ouattara officiellement aux commandes	Environnement	
[ 14 juin 2021 ] SOCIETE	
[ 14 juin 2021 ] Musique burkinabè : Amzy s’est marié en cachette samedi dernier	TECHNOLOGIE	
[ 8 juin 2021 ] France : le président Macron giflé par un homme	INTERNATIONAL	
[ 27 mai 2021 ] Prévisions météo : l’ANAM annonce des risques d’inondation sur tout le pays	Environnement	
[ 27 mai 2021 ] Litige foncier à Kossodo et Roumtenga : plusieurs familles à couteaux tirés	SOCIETE	
[ 27 mai 2021 ] Insécurité au Burkina : Le projet GOLCOS comme alternative	DEFENSE-SECURITE	
[ 27 mai 2021 ] Importation de lunettes : Les opticiens du Burkina pour un meilleur contrôle	Santé	
[ 24 mai 2021 ] Pèlerinage 2021 : les dispositions pour être éligible au Hadj	SOCIETE	
[ 24 mai 2021 ] Conseil des ministres du lundi 24 mai 2021	Conseil des ministres	
[ 24 mai 2021 ] Crise scolaire : Le lycée Zinda fermé, les grandes décisions du gouvernement !	Education	
[ 21 mai 2021 ] Sinistre dans les marchés et yaars : La CCI-BF prévoit un fonds de solidarité	ECONOMIE-DEVELOPPEMENT	
[ 12 mai 2021 ] Fraude fiscale au Burkina : Des faussaires aux arrêts, plus de 16 milliards FCFA de préjudice	DEFENSE-SECURITE	
[ 2 mai 2021 ] Délestages intempestifs : les explications du DG de la SONABEL	SOCIETE	
[ 23 avril 2021 ] Police municipale de Ouaga : une vingtaine de machines à sous illégales saisies	DEFENSE-SECURITE	
[ 23 avril 2021 ] Arrondissement 7 de Bobo : De femmes demandent la libération du maire Herman Sirima	SOCIETE	
[ 22 avril 2021 ] Finances publiques : La commune de Ouaga rend compte	Coopération	
[ 22 avril 2021 ] Préparatifs assises nationales éducation : Ouaro échange avec ses prédécesseurs	Education	
[ 22 avril 2021 ] Ouagadougou : la police municipale met des porcs en fourrière	SOCIETE	
[ 22 avril 2021 ] CENI : Les deux nouveaux commissaires de l’Opposition prêtent serment !	POLITIQUE	
[ 22 avril 2021 ] Galian 2021 : Les jurys installés, 258 œuvres en compétition	SOCIETE	
[ 22 avril 2021 ] Contrefaçon médicaments et cigarettes à Ouaga : Plus de 56 millions FCFA de marchandises saisies	DEFENSE-SECURITE	
[ 20 avril 2021 ] Insécurité au Burkina : plus de 1 147 699 déplacés internes enregistrés	DEFENSE-SECURITE	
[ 20 avril 2021 ] Région de l’Est : Un terroriste abattu par les FDS	DEFENSE-SECURITE	
[ 15 avril 2021 ] Réconciliation nationale : Le rapport d’activités du MPCRN fin prêt	POLITIQUE	
[ 14 avril 2021 ] Compte rendu du Conseil des ministres du 14 avril 2021	Conseil des ministres	
[ 14 avril 2021 ] Insécurité à l’Est: un terroriste abattu par les FDS	DEFENSE-SECURITE	
[ 14 avril 2021 ] Mise en œuvre arrêté portant interdiction consommation chicha : les différents acteurs en concertation	Santé	
[ 14 avril 2021 ] Marché bétail Ouagarinter : Concertation autour du déménagement	ECONOMIE-DEVELOPPEMENT	
[ 9 avril 2021 ] Arrondissement 1 Ouaga : La police municipale détruit une dizaine de boutiques	DEFENSE-SECURITE	
[ 7 avril 2021 ] Commune de Ouaga : Le maire interdit la consommation de Chicha	Santé	
[ 6 avril 2021 ] Régions du Centre-Sud et de l’Ouest : Drogue, explosifs et médicaments contrefaits saisis par la Douane	Santé	
[ 3 avril 2021 ] Bonheurville/Ouaga : 2 morts dans l’effondrement d’un immeuble	SOCIETE	
[ 2 avril 2021 ] Protection données personnelles : La CIL remet ses rapports 2018 et 2019 au Conseil constitutionnel	TECHNOLOGIE	
[ 1 avril 2021 ] Vaccins contre la COVID19 : Le processus d’acquisition est avancé	Santé	
[ 24 mars 2021 ] Réformes du ministère de la Fonction publique : Le Consul honoraire de Monaco félicite le ministre Séni Ouédraogo	Coopération	
[ 24 mars 2021 ] Vente illicite de parcelles : Un réseau de faussaires dans les filets de police nationale	DEFENSE-SECURITE	
[ 23 mars 2021 ] Bureau des Douanes Ouessa : Saisie record de près 3 tonnes de chanvre indien	DEFENSE-SECURITE	
[ 20 mars 2021 ] Réconciliation nationale : Le CRARP veut apporter sa pierre	SOCIETE	
[ 18 mars 2021 ] Traffic de drogue : Près de 400 kg de chanvre indien saisis	DEFENSE-SECURITE	
[ 18 mars 2021 ] Réformes des examens et concours : Pas de suppression du second tour au BAC et au BEPC 2021	Education	
[ 18 mars 2021 ] Réconciliation nationale : Diabré en quête du soutien des Parlementaires	POLITIQUE	
[ 18 mars 2021 ] Danhal Kpangara/Sud-ouest : Une intoxication alimentaire fait sept morts	SOCIETE	
[ 17 mars 2021 ] Bissiga / Centre-est : Le proviseur du lycée départemental séquestré par des élèves	Education	
[ 16 mars 2021 ] Ouaga : Des médicaments d’une valeur de plus de 5 millions FCFA saisis	DEFENSE-SECURITE	
[ 11 mars 2021 ] Cote d’Ivoire : Décès du Premier ministre Hamed Bakayoko	INTERNATIONAL	
[ 4 mars 2021 ] Dr Jean-Baptiste Ouédraogo : « La réconciliation nationale dans notre pays est un mal nécessaire »	POLITIQUE	
[ 4 mars 2021 ] Clément Sawadogo : « Il y a aucune zone d’ombre entre l’UPC et les autres partis de l’APMP »	POLITIQUE	
[ 4 mars 2021 ] Zéphirin Diabré : « La réconciliation nationale est devenue une grande priorité »	POLITIQUE	
[ 3 mars 2021 ] Burkina : Les municipales reportées en mai 2022 (Conseil des ministres)	Conseil des ministres	
[ 3 mars 2021 ] Pensa (Centre-nord) : Le maire Issaka Sawadogo aux arrêts	SOCIETE	
[ 3 mars 2021 ] Violences basées sur le genre : Un numéro vert pour dénoncer les cas !	SOCIETE	
[ 2 mars 2021 ] CIL : Le président Kaboré reçoit les rapports 2018 et 2019	TECHNOLOGIE	
[ 2 mars 2021 ] Décès de Claudine Ouédraogo : Derniers hommages de l’hémicycle à la défunte	SOCIETE	
[ 2 mars 2021 ] Cités Abdoul’ Services Ouaga 2000 et Saaba : Le processus de viabilisation bien en marche	SOCIETE	
[ 2 mars 2021 ] CCI-BF : 15 643 nouvelles entreprises ont été créées en 2020	ECONOMIE-DEVELOPPEMENT	
[ 2 mars 2021 ] Forum d’Aswan : Appel à l’annulation de la dette des pays africains	ECONOMIE-DEVELOPPEMENT	
[ 1 mars 2021 ] Ouaga : François Bouda immortalisé sur une rue	SOCIETE	
[ 1 mars 2021 ] Ouaga : La police démantèle un réseau de faussaires	DEFENSE-SECURITE	
[ 23 février 2021 ] Crise dans les écoles de Santé : Le SYNTSHA Kadiogo pointe la responsabilité du DG Emile Paré	Déclarations	
[ 8 février 2021 ] Tournée du MATD : Le FPDCT est une structure fondamentale pour Clément Sawadogo	ECONOMIE-DEVELOPPEMENT	
[ 29 janvier 2021 ] Conseil des ministres : Le 27e FESPACO reporté	Conseil des ministres	
[ 28 janvier 2021 ] Province du Séno : Les FDS neutralisent une mine artisanale	DEFENSE-SECURITE	
[ 28 janvier 2021 ] Saponé, Ypélsé, Sapouy : Suspension temporaire de la fourniture de l’électricité ce samedi	Communiqués	
[ 28 janvier 2021 ] Gourcy : 3 morts dans un accident	SOCIETE	
[ 28 janvier 2021 ] Région de l’Est : le couvre-feu prorogé au 30 mars 2021	DEFENSE-SECURITE	
[ 28 janvier 2021 ] Région du Sahel : les sites miniers fermés jusqu’au 14 avril	DEFENSE-SECURITE	
[ 27 janvier 2021 ] Mise en circulation de faux billets : Fin de parcours cinq malfrats	DEFENSE-SECURITE	
[ 26 janvier 2021 ] Burkina : L’ADF-RDA pour une « opposition républicaine et constructive »	POLITIQUE	
[ 25 janvier 2021 ] Bassolma Bazié : « C’est une démission qui me permettra de mieux défendre les intérêts des travailleurs »	SOCIETE	
[ 24 janvier 2021 ] CEDEAO : Les grandes décisions de la 58e Conférence des chefs d’Etat et de gouvernement	POLITIQUE	
[ 24 janvier 2021 ] Burkina : Bassolma Bazié de la CGTB démissionne de la Fonction publique	SOCIETE	
[ 22 janvier 2021 ] Burkina gold trading international : Devenir la première société commerciale d’approvisionnement en or traçable du Burkina	ECONOMIE-DEVELOPPEMENT	
[ 20 janvier 2021 ] USA : Joe Biden investi 46e président	INTERNATIONAL	
[ 19 janvier 2021 ] W. Bruno Compaoré, DG FBDES : De nombreux acquis enregistrés en 2020 malgré le contexte difficile	ECONOMIE-DEVELOPPEMENT	
[ 19 janvier 2021 ] USA : Les priorités du président élu Joe Biden	INTERNATIONAL	
[ 17 janvier 2021 ] Le Faso Autrement : l’ex-député Boukaré Kouanda retrouvé mort dans une clairière	SOCIETE	
[ 15 janvier 2021 ] Abraham Nignan : « Zéphirin Diabré peut-il dire que c’est le vrai changement là où il se trouve aujourd’hui ? »	POLITIQUE	
[ 12 janvier 2021 ] Zéphirin Diabré : « C’est d’abord à nous-mêmes que nous devons rendre compte et à personne d’autre »	POLITIQUE	
[ 12 janvier 2021 ] Problèmes dans la Gestion du fret au Burkina : le HCT-BF charge le CBC et la FUTRB	ECONOMIE-DEVELOPPEMENT	
[ 11 janvier 2021 ] Lassané Savadogo, secrétaire exécutif du MPP : « La nomination de Zéphirin Diabré est un signal fort »	POLITIQUE	
[ 10 janvier 2021 ] Burkina : Un nouveau gouvernement de 26 ministres avec Zéphirin Diabré	POLITIQUE	
[ 5 janvier 2021 ] An 2 Bruno Dipama à la tête du FPDCT : Plus de 12 000 projets financés de 2008 à 2020	ECONOMIE-DEVELOPPEMENT	
[ 30 décembre 2020 ] Burkina : Le président Kaboré dissout le gouvernement	POLITIQUE	
[ 14 décembre 2020 ] 11-Décembre à Banfora : L’organisation sabotée selon Abdoulaye Soma	ECONOMIE-DEVELOPPEMENT	
[ 10 décembre 2020 ] 60e anniversaire de l’indépendance : Le message du président Kaboré	POLITIQUE	
[ 24 novembre 2020 ] Site minier d’Arra/Sahel : 5 VDP tués et 3 portés disparus	DEFENSE-SECURITE	
[ 22 novembre 2020 ] Présidentielle du 22 novembre : « Nous n’accepterons pas d’aller cautionner des résultats entachés de fraude et d’irrégularité », Zéphirin Diabré	POLITIQUE	
[ 21 novembre 2020 ] 25es Nuits Atypiques de Koudougou : une trentaine d’artistes invités	CULTURE	
[ 20 novembre 2020 ] Accusation de fraude par Zeph : Un non-sens selon Roch Marc Kaboré	POLITIQUE	
[ 20 novembre 2020 ] Meeting de clôture de Roch : « Le MODEM a un avenir parce que le coup K.O. a été téléchargé », Nathanaël Ouédraogo	POLITIQUE	
[ 20 novembre 2020 ] Daouda Simboro : « Roch est le seul homme de la situation »	POLITIQUE	
[ 11 novembre 2020 ] Commémoration 11-décembre à Banfora : Le FPDCT se fait remarquer au défilé	SOCIETE	
[ 5 novembre 2020 ] Présidentielle du 22 novembre : Roch Marc Kaboré lance sa machine à partir de Bobo	POLITIQUE	
[ 31 octobre 2020 ] Campagne électorale : Zéphirin Diabré lance les hostilités à Tenkodogo	POLITIQUE	
[ 31 octobre 2020 ] Présidentielle : L’hymne de campagne de Zeph porte la griffe d’Extra Musica	CULTURE	
[ 29 octobre 2020 ] Burkina : Nathanaël Ouédraogo et le Poé Naba créent le Modem	POLITIQUE	
[ 28 octobre 2020 ] Exactions présumées des FDS et VDP : « Tolérer ces dérives n’est pas seulement lâche, mais suicidaire », Dr Diallo du CISC	SOCIETE	
[ 27 octobre 2020 ] Burkina : Bila Kaboré, père du président du Faso a tiré sa révérence !	POLITIQUE	
[ 19 octobre 2020 ] Yvelines /France : Un professeur d’histoire décapité après avoir montré des caricatures de Mahomet	INTERNATIONAL	
[ 19 octobre 2020 ] Législatives du 22 novembre : 8 listes nationales invalidées par le Tribunal administratif	POLITIQUE	
[ 13 octobre 2020 ] Burkina : Des experts internationaux auditent le fichier électoral	POLITIQUE	
[ 10 octobre 2020 ] Covid-19/Burkina : Essakane SA offre du matériel d’une valeur de 140 millions FCFA au CHR de Dori	Santé	
[ 8 octobre 2020 ] Enseignement supérieur/Burkina : L’IAM devient l’Université de l’unité africaine	Education	
[ 5 octobre 2020 ] Grand banditisme et criminalité urbaine : La police nationale met aux arrêts deux gangs	DEFENSE-SECURITE	
[ 4 octobre 2020 ] Mahamadi Kouanda, président du Congrès pour la renaissance et le progrès : « Je ne regrette pas d’avoir quitté le CDP »	POLITIQUE	
[ 4 octobre 2020 ] Présidentielle 2020 au Burkina : 23 candidatures reçues dont 3 femmes	POLITIQUE	
[ 3 octobre 2020 ] Dakar/Sénégal : Le président Roch Marc Kaboré en visite privée	POLITIQUE	
[ 21 septembre 2020 ] Législatives du 22 novembre : La liste complète de l’APR Tiligré	POLITIQUE	
[ 21 septembre 2020 ] Législatives du 22 novembre : La liste des candidats de l’ADF/RDA	POLITIQUE	
[ 6 décembre 2021 ] Rapport sur le drame d’Inata: Le président Kaboré rejette le document jugé insatisfaisant	DEFENSE-SECURITE	
Rechercher :
AccueilSOCIETEBurkina : Réouverture des frontières le 1er décembre, voici les conditions !
Burkina : Réouverture des frontières le 1er décembre, voici les conditions !
17 novembre 2021 Burkina News SOCIETE 0
Le Conseil, en sa séance du mercredi 17 novembre 2021, a adopté un décret portant réouverture des frontières terrestres et ferroviaires du Burkina Faso. Pour compter du 1er décembre 2021, les frontières terrestres et ferroviaires du Burkina Faso seront ouvertes. Toutefois, l’accès ou la sortie du territoire burkinabè est subordonné au respect de l’une des conditions suivantes pour toute personne âgée d’au moins 11 ans :
– la fourniture d’une carte de vaccination contre la COVID-19 ou tout document attestant le schéma complet de vaccination contre la COVID-19 datant d’au moins 14 jours ;
– la présentation d’un document attestant un test PCR négatif datant d’au plus 5 jours à compter de la date du prélèvement ;
– la présentation d’un document attestant un test de diagnostic rapide négatif d’au plus 5 jours à compter de la date du prélèvement.
Le présent décret maintient les conditions sanitaires de voyage par voie aérienne, conformément aux directives communautaires de l’UEMOA relatives à la gestion de la pandémie de la maladie à coronavirus.
Burkinanews.info
COVID-19
Frontières du Burkina
Réouverture des frontières au Burkina
Précédent
Attaque détachement gendarmerie Inata : le bilan revu à la hausse !
Suivant
Drame d’Inata : le commandant du Groupement des forces du secteur Nord et celui de la 1re Région de gendarmerie relevés de leurs fonctions !
Sur le même thème
Santé	
Covid-19/Burkina : Essakane SA offre du matériel d’une valeur de 140 millions FCFA au CHR de Dori	
10 octobre 2020 Burkina News Santé, SOCIETE 0
Fidèle à sa réputation d’entreprise citoyenne, la société minière IAMGOLD Essakane SA a offert du matériel médico-technique d’une valeur de 140 millions de francs CFA au Centre hospitalier régional (CHR) de Dori. La cérémonie était […]
Coopération	
Covid-19 : Le Burkina reçoit 400 mille doses du vaccin Sinopharm	
19 septembre 2021 Burkina News Coopération, SOCIETE 0
La ministre déléguée chargée de l’Intégration africaine et des Burkinabè de l’extérieur, Clarisse Mérindol/Ouoba, a réceptionné un lot de 400 mille doses de vaccin anti-COVID-19 Sinopharma, le samedi 18 septembre 2021. Il s’agit d’un don […]
Education	
Orientation scolaire au Burkina : Ouaro veut redynamiser le DIOSPB	
3 septembre 2020 Burkina News Education, SOCIETE 0
Le ministère de l’Education nationale, de l’Alphabétisation et de la Promotion des Langues nationales a tenu, jeudi 3 septembre 2020 une rencontre sous le thème : « l’information et l’orientation scolaire dans le système éducatif burkinabè : […]
Soyez le premier à commenter	
Laisser un commentaire Annuler la réponse
Votre adresse de messagerie ne sera pas publiée.
Commentaire
Nom *
Courriel *
Site web
Save my name, email, and website in this browser for the next time I comment.
Nous suivre sur Facebook
Rechercher :
Articles récents
Rapport sur le drame d’Inata: Le président Kaboré rejette le document jugé insatisfaisant
Grande muraille verte : 4e rencontre au sommet sur le financement du programme
Réseau des organismes de gestion des financements aux médias de la CEDEAO : Ag Ibrahim Mohamed prend les rênes !
Burkina: Les boulangers annoncent une augmentation du prix du pain
Message du président du Faso a la nation : Les Burkinabè veulent désormais plus de pragmatisme !
BURKINANEWS TV
PUBLICITE
Créer un menu personnalisé sous "Apparence => Menus" dans votre tableau de bord WordPress pour afficher les icônes sociales dans ce widget.
FASOMETRE
AU TOP
Bruno S. DIPAMA, Directeur Général du Fonds Permanent pour le Développement des Collectivités Territoriales (FPDCT)
AU TAPIS
Chériff Moumina SY, ministre de la Défense nationale et des Anciens Combattants
RESTEZ CONNNECTE
Créer un menu personnalisé sous "Apparence => Menus" dans votre tableau de bord WordPress pour afficher les icônes sociales dans ce widget.